11111111111111111111111111111111111111111111111111
10000000000000000000000000000000000000000000000001
10800000000000000000000000000000000000000000000001
10000000000000000000000000000000000000000000000001
10000000000000000000000000000000000000000000000001
10000000000000000000000000000000000000000000000001
10000000000000000000000000000000000000000000000001
10000000000000000000000000000000000000000000000001
10000000000000000000000000000000000000000000000001
10000000000000000000000000000001111000000000000001
10000000000000000000000000000000001110000000000001
10000000000000000000000000000000000011100000000001
10000000000000000000000000000000000000110000000001
10000000000000000000000000000000000000011000000001
10000000000000000000000000000000000000001100000001
10000000000000000000000000000000000000001100000001
10000000000000000000000000000000000000001100000001
11111111111111111111111111111111111111111100000001
10000000000000000000000000000100000000000000000001
10000000000000000000000000000000000000000000000001
10000000000000000000000000000100000000000000000001
10000001111111111111111111111111111111111111111111
10000000011000000000000000000111000000000000000001
10000000011000000000011100000111000001100000000001
10000000001000000000011100000111000001100000000001
10000000001000000000011100000000000001100000000001
10000000001900000000011100000000000001100000000001
10001111111111111111111111111111111111111111000001
10000000000000000000000000000000000000000001000001
10000000000000000000000000000000000000000001000001
10000000000000000000000000000000000000000001000001
11111111111111111111111111111111111111100001000001
10000000000000000000000000000000000000000001000001
10000000000000000000000000000000000000000001000001
10000000000000000000000000000000000000000001000001
10000011111111111111111111111111111111111111000001
10000000000000000000000000000000000000000000000001
10000000000000000000000000000000000000000000000001
10000000000000000000000000000000000000000000000001
11111111111111111111111111111111111111111111111111